12 17
00000000000000000
01666666666620000
05000000000050000
04666662000050000
00000005000050000
00000005000050000
00016663000050000
00050000000050000
00050000000046620
00050000000000050
00046666666666630
00000000000000000
1 1
